60.ox
.....o..o.....o.....o.o........o....o............ooo.o......
.o...o...........o...o..............o..............o.oo.....
..o..o......o..............o.o..o.....oo...........oo.......
...............o...ooo.o..o......oo..oo...o........o........
....o...o.oo............o...ooo........o.....o.......o.....o
o........o.o....................o.o.o..o....................
......o..o.....o...........o..o......................o.o....
..oo........o........o..o...o..o..o.o.o.............o.o..o..
......o..o....oo.o......o...o..............oo.o......oo.o...
o....oo..o...o................o.............................
oo..............o.o........oo........o....o...o.........o..o
o.........o.......o......o................o.....o...........
...o....o.....o........o.....o.....o...ooo.......o.....o....
..oo.oo................o...o.....................o....o..o..
.o...o.o....o.....o...oo....o...o.o...o........oo........ooo
......oo.....o...o.....................o.o..............o.o.
........o..o.o.o........o..o.o....o.o......o.ooo...o......oo
...o..........o....o.....oo.......oo...........oo...o......o
...o.....o....oo....oo..o........o.o......o.................
......o.o.o....ooo...oo..o...oo....o.....o.o.....o..........
...o..........o.......o..o.o......o.................o....o..
.o...o...o.......ooo..o.oo........o.........o.....o.........
o...o......o.........o.......o.o.................o........o.
...o................o........o..o......o..o..oo...o......o..
..........o..........o..o.o.................o....o..o.......
.o.......oo......o.....o.................o.o......o.o.o....o
........oo........oo.......o.....................o......o.o.
.........................o....o.o..o..........o.o.o......o..
....o..oo.....o........o..o..o.o..o.ooo.o...............o...
......o.o.......oo.......o..o.........o....o...o...........o
o.................o.........oo........o......o....oo.o.o.o..
o.......o....o..o...o..........o..o.....o...o...............
................o......o........o...o..o.........o..........
o.o.oo......o........o..o..................o...o....oo...o..
..o.....o..o.o.......o..........o......................o....
o.o..o....o....o.....o...o....o..............o....o.........
..........o.........o.o......................o.....oo.....o.
...........oo.....o...o.....................oo............o.
..oo.o...o.ooo......o..............o.........oo.o...o....o..
..o...oo.oo.................................................
..o...o...oo....o.....o..o..o................o...o.....o....
..o.....................o.....o..o..........o..o.......o....
......oo...o......o.....o...o..oo.o..o......o.............o.
...o......o..o....o......o......o.......o......ooo..o...o...
...oo......................oo..o.o.............o..o......o.o
.....o..o.....o.........................o.....o.o...oo....o.
..........o...........o..o.oo..o.................ooo..o....o
.......o.........oo.o..o......o..o.oo....o....o.............
.o....o...........o......o........o......o..oo.....o........
..o...oo................................oo......o...........
o..........o.o.........o...............o.....o.o.....o....o.
..o...............o.......o........o..o.........o.....o.....
...o.....oo......o...o..o..............o.........o.o..o.....
.................oo.........o...o...o..o..........o.o....o..
..o...o......o...o......ooo...o.oo......o..o.o.oo......o....
..o.o...o.o....oo.....oo.......o.....o..........o...........
.oo...ooo...o......o......o.o.ooo...o.o............o....oo..
...o.........................o.......o........o..oo.........
...o..o...........o..o..o.......o.....o.......o..o.o..o.o...
.o.o...o..........o......o...o.....oo.......................
